# 0 - standard brick
# 1 - larger bat
# 2 - Slow ball
# 3 - Multi ball



00000000000000000000
00000000000000000000
00010020000002001000


00000000000000000000
00000000000000000000
00010000000000001000


00000000000000000000
10000300000000300001
00020004000040002000
44444444444444444444